|様様様様|
|   OOOO |
|        |
|        |
|        |
|        |
|        |
|        |
| OOO    |
||様様様様|
